A
advanced = lanjut
align = perataan
author = pengarang
arrow key = tombol panah


B
bar = bilah
bookmark = markah buku
bullet = bulatan

C
cancel = batal
cell = sel
check box = kotak centang
chart  = bagan
close = tutup
column = kolom
content = konten
count = hitung
copy = salin (kk), salinan (kb)
custom = ubahan (misal : custom color = warna ubahan)
current = saat ini
custom = tersuai / ubahan (misal : custom color = warna tersuai) --cek

D
database = pangkalan data
default = baku, bawaan
description = deskripsi, keterangan
digital = digital
disable = matikan
disabled = dimatikan
disc = ?
disk = diska
document = dokumen
download = unduh
driver = pemacu/penggerak --cek

E
email = surel
embed = tanamkan
enable = nyalakan
enabled = dinyalakan
error = galat
event = acara
export = ekspor
extension = ekstensi
entry = entri

F
field = ruas
file = berkas
footer = kaki
format = format
floating point = titik apung

G
grid = kisi

H
home = beranda
header = tajuk
hyperlink = pranala
hardisk = diska

I
image = citra
import = impor
insert = sisipkan
item = item

J


K


L
library = pustaka
libraries = pustaka
list entry = daftar masukan

M
margin = batasan
main = utama
mean = rerata
mouse = tetikus
menu = menu

N
navigator = navigator
null = nol


O
offline = luring
online = daring
on the fly = dengan cepat
option = opsi, pilihan
output = keluaran
overwrite = menimpa
overview = ikhtisar

P
pause = jeda (kb) menjeda (kk)
pop up = ?
preview = pratinjau
printer = pencetak
path = jalur

Q


R
range = rentang
recent = terkini
reference = referensi
region = wilayah
remove = hapuskan
restart = mulai ulang
review = tinjau
row = baris

S
setting = pengaturan
server = server
shape = bentuk
shortcut = pintasan
slide = salindia
spreadsheet = ?

T
tab = ?
template = templat
text = teks
through = lewati
thumbnail = thumbnail
toogle = jungkit
toolbar = bilah alat
tools = perkakas
type = tipe

U
update = pemutakhiran (kb), mutakhirkan (kk)
upload = unggah
user = pengguna
username = nama pengguna

V
valid = valid
view = tampilan

W
wizard = wisaya
worksheet = lembar kerja
wrap = bungkus

X


Y


Z
ZIP = kode pos
